Line 1	

UlitsaPodbelskogo	Cherkizovskaya
Cherkizovskaya	PreobrazhenskayaPloshchad
PreobrazhenskayaPloshchad	Sokolniki
Sokolniki	Krasnoselskaya
Krasnoselskaya	Komsomolskaya
Komsomolskaya	KrasniyeVorota
KrasniyeVorota	ChistiyePrudy-SretenskyBulvar-Turgenevskaya
ChistiyePrudy-SretenskyBulvar-Turgenevskaya	Lubyanka-KuznetskyMost
Lubyanka-KuznetskyMost	OkhotnyiRyad-PloshchadRevolyutsii-Teatralnaya
OkhotnyiRyad-PloshchadRevolyutsii-Teatralnaya	AlexandrovskySad-Arbatskaya-BibliotekaImeniLenina-Borovitskaya
AlexandrovskySad-Arbatskaya-BibliotekaImeniLenina-Borovitskaya	Kropotkinskaya
Kropotkinskaya	ParkKultury
ParkKultury	Frunzenskaya
Frunzenskaya	Sportivnaya
Sportivnaya	VorobyovyGory
VorobyovyGory	Universitet
Universitet	ProspektVernadskogo
ProspektVernadskogo	Yugo-Zapadnaya

Line 2	

RechnoiVokzal	VodnyStadion
VodnyStadion	Voykovskaya
Voykovskaya	Sokol
Sokol	Aeroport
Aeroport	Dinamo
Dinamo	Belorusskaya
Belorusskaya	Mayakovskaya
Mayakovskaya	Chekhovskaya-Pushkinskaya-Tverskaya
Chekhovskaya-Pushkinskaya-Tverskaya	OkhotnyiRyad-PloshchadRevolyutsii-Teatralnaya
OkhotnyiRyad-PloshchadRevolyutsii-Teatralnaya	Novokuznetskaya-Tretyakovskaya
Novokuznetskaya-Tretyakovskaya	Paveletskaya
Paveletskaya	Avtozavodskaya
Avtozavodskaya	Kolomenskaya
Kolomenskaya	Kashirskaya
Kashirskaya	Kantemirovskaya
Kantemirovskaya	Tsaritsyno
Tsaritsyno	Orekhovo
Orekhovo	Domodedovskaya
Domodedovskaya	Krasnogvardeyskaya

Line 3	

Shchyolkovskaya	Pervomayskaya
Pervomayskaya	Izmaylovskaya
Izmaylovskaya	Pervomayskaya(closed)
Pervomayskaya(closed)	Partizanskaya
Partizanskaya	Semyonovskaya
Semyonovskaya	Elektrozavodskaya
Elektrozavodskaya	Baumanskaya
Baumanskaya	Chkalovskaya-Kurskaya
Chkalovskaya-Kurskaya	OkhotnyiRyad-PloshchadRevolyutsii-Teatralnaya
OkhotnyiRyad-PloshchadRevolyutsii-Teatralnaya	AlexandrovskySad-Arbatskaya-BibliotekaImeniLenina-Borovitskaya
AlexandrovskySad-Arbatskaya-BibliotekaImeniLenina-Borovitskaya	Smolenskaya-L3
Smolenskaya-L3	Kiyevskaya
Kiyevskaya	ParkPobedy
ParkPobedy	SlavyanskyBulvar
SlavyanskyBulvar	Kuntsevskaya
Kuntsevskaya	Molodyozhnaya
Molodyozhnaya	Krylatskoe
Krylatskoe	Strogino

Line 4	

Kuntsevskaya	Pionerskaya
Pionerskaya	FilyovskyPark
FilyovskyPark	Bagrationovskaya
Bagrationovskaya	Fili
Fili	Kutuzovskaya
Kutuzovskaya	Studencheskaya
Studencheskaya	Mezhdunarodnaya
Mezhdunarodnaya	Vystavochnaya
Vystavochnaya	Kiyevskaya
Kiyevskaya	Smolenskaya-L4
Smolenskaya-L4	Arbatskaya
Arbatskaya	AlexandrovskySad-Arbatskaya-BibliotekaImeniLenina-Borovitskaya

Line 5	

ParkKultury	Oktyabrskaya
Oktyabrskaya	Dobryninskaya-Serpukhovskaya
Dobryninskaya-Serpukhovskaya	Paveletskaya
Paveletskaya	Marksistskaya-Taganskaya
Marksistskaya-Taganskaya	Chkalovskaya-Kurskaya
Chkalovskaya-Kurskaya	Komsomolskaya
Komsomolskaya	ProspektMira
ProspektMira	Mendeleyevskaya-Novoslobodskaya
Mendeleyevskaya-Novoslobodskaya	Belorusskaya
Belorusskaya	Barrikadnaya-Krasnopresnenskaya
Barrikadnaya-Krasnopresnenskaya	Kiyevskaya

Line 6	

Medvedkovo	Babushkinskaya
Babushkinskaya	Sviblovo
Sviblovo	BotanicheskySad
BotanicheskySad	VDNKh
VDNKh	Alexeyevskaya
Alexeyevskaya	Rizhskaya
Rizhskaya	ProspektMira
ProspektMira	Sukharevskaya
Sukharevskaya	ChistiyePrudy-SretenskyBulvar-Turgenevskaya
ChistiyePrudy-SretenskyBulvar-Turgenevskaya	Kitay-Gorod
Kitay-Gorod	Novokuznetskaya-Tretyakovskaya
Novokuznetskaya-Tretyakovskaya	Oktyabrskaya
Oktyabrskaya	Shabolovskaya
Shabolovskaya	LeninskyProspekt
LeninskyProspekt	Akademicheskaya
Akademicheskaya	Profsoyuznaya
Profsoyuznaya	NoviyeCheryomushki
NoviyeCheryomushki	Kaluzhskaya(closed)
Kaluzhskaya(closed)	Kaluzhskaya
Kaluzhskaya	Belyayevo
Belyayevo	Konkovo
Konkovo	TyoplyiStan
TyoplyiStan	Yasenevo
Yasenevo	Novoyasenevskaya

Line 7	

Planernaya	Skhodnenskaya
Skhodnenskaya	Tushinskaya
Tushinskaya	Shchukinskaya
Shchukinskaya	OktyabrskoyePole
OktyabrskoyePole	Polezhaevskaya
Polezhaevskaya	Begovaya
Begovaya	Ulitsa1905Goda
Ulitsa1905Goda	Barrikadnaya-Krasnopresnenskaya
Barrikadnaya-Krasnopresnenskaya	Chekhovskaya-Pushkinskaya-Tverskaya
Chekhovskaya-Pushkinskaya-Tverskaya	Lubyanka-KuznetskyMost
Lubyanka-KuznetskyMost	Kitay-Gorod
Kitay-Gorod	Marksistskaya-Taganskaya
Marksistskaya-Taganskaya	KrestyanskayaZastava-Proletarskaya
KrestyanskayaZastava-Proletarskaya	VolgogradskyProspekt
VolgogradskyProspekt	Tekstilshchiki
Tekstilshchiki	Kuzminki
Kuzminki	RyazanskiyProspekt
RyazanskiyProspekt	Vykhino

Line 8	

Novogireevo	Perovo
Perovo	ShosseEntuziastov
ShosseEntuziastov	Aviamotornaya
Aviamotornaya	PloshchadIlicha-Rimskaya
PloshchadIlicha-Rimskaya	Marksistskaya-Taganskaya
Marksistskaya-Taganskaya	Novokuznetskaya-Tretyakovskaya

Line 9	

Altufyevo	Bibirevo
Bibirevo	Otradnoye
Otradnoye	Vladykino
Vladykino	Petrovsko-Razumovskaya
Petrovsko-Razumovskaya	Timiryazevskaya
Timiryazevskaya	Dmitrovskaya
Dmitrovskaya	Savyolovskaya
Savyolovskaya	Mendeleyevskaya-Novoslobodskaya
Mendeleyevskaya-Novoslobodskaya	TsvetnoyBulvar
TsvetnoyBulvar	Chekhovskaya-Pushkinskaya-Tverskaya
Chekhovskaya-Pushkinskaya-Tverskaya	AlexandrovskySad-Arbatskaya-BibliotekaImeniLenina-Borovitskaya
AlexandrovskySad-Arbatskaya-BibliotekaImeniLenina-Borovitskaya	Polyanka
Polyanka	Dobryninskaya-Serpukhovskaya
Dobryninskaya-Serpukhovskaya	Tulskaya
Tulskaya	Nagatinskaya
Nagatinskaya	Nagornaya
Nagornaya	NakhimovskyProspekt
NakhimovskyProspekt	Kakhovskaya-Sevastopolskaya
Kakhovskaya-Sevastopolskaya	Chertanovskaya
Chertanovskaya	Yuzhnaya
Yuzhnaya	Prazhskaya
Prazhskaya	UlitsaAkademikaYangelya
UlitsaAkademikaYangelya	Annino
Annino	BulvarDmitriyaDonskogo-UlitsaStarokachalovskaya

Line 10	

Trubnaya-TsvetnoyBulvar	ChistiyePrudy-SretenskyBulvar-Turgenevskaya
ChistiyePrudy-SretenskyBulvar-Turgenevskaya	Chkalovskaya-Kurskaya
Chkalovskaya-Kurskaya	PloshchadIlicha-Rimskaya
PloshchadIlicha-Rimskaya	KrestyanskayaZastava-Proletarskaya
KrestyanskayaZastava-Proletarskaya	Dubrovka
Dubrovka	Kozhukhovskaya
Kozhukhovskaya	Pechatniki
Pechatniki	Volzhskaya
Volzhskaya	Lyublino
Lyublino	Bratislavskaya
Bratislavskaya	Maryino

Line 11	

Kashirskaya	Varshavskaya
Varshavskaya	Kakhovskaya-Sevastopolskaya

Line L1	

BulvarDmitriyaDonskogo-UlitsaStarokachalovskaya	UlitsaSkobelevskaya
UlitsaSkobelevskaya	BulvarAdmiralaUshakova
BulvarAdmiralaUshakova	UlitsaGorchakova
UlitsaGorchakova	BuninskayaAlleya
