Yongsan	Ichon
Ichon	Seobinggo
Seobinggo	Hannam
Hannam	Oksu
Oksu	Eungbong
Eungbong	Wangsimni
Wangsimni	Cheongnyangni
Cheongnyangni	Hoegi
Hoegi	Jungnang
Jungnang	Sangbong
Sangbong	Mangu
Mangu	Yangwon
Yangwon	Guri
Guri	Donong
Donong	Yangjeong
Yangjeong	Deokso
Deokso	Dosim
Dosim	Paldang
Paldang	Ungilsan
Ungilsan	Yangsu
Yangsu	Sinwon
Sinwon	Guksu
Guksu	Asin
Asin	Obin
Obin	Yangpyeong
Yangpyeong	Wondeok
Wondeok	Yongmun
