Eungam	Yeokchon
Yeokchon	Bulgwang
Bulgwang	Dokbawi
Dokbawi	Yeonsinnae
Yeonsinnae	Gusan
Gusan	Eungam
Eungam	Saejeol
Saejeol	Jeungsan
Jeungsan	DigitalMediaCity
DigitalMediaCity	WorldCupStadium
WorldCupStadium	Mapo-guOffice
Mapo-guOffice	Mangwon
Mangwon	Hapjeong
Hapjeong	Sangsu
Sangsu	Gwangheungchang
Gwangheungchang	Daeheung
Daeheung	Gongdeok
Gongdeok	HyochangPark
HyochangPark	Samgakji
Samgakji	Noksapyeong
Noksapyeong	Itaewon
Itaewon	Hangangjin
Hangangjin	Beotigogae
Beotigogae	Yaksu
Yaksu	Cheonggu
Cheonggu	Sindang
Sindang	Dongmyo
Dongmyo	Changsin
Changsin	Bomun
Bomun	Anam
Anam	KoreaUniversity
KoreaUniversity	Wolgok
Wolgok	Sangwolgok
Sangwolgok	Dolgoji
Dolgoji	Seokgye
Seokgye	Taereung
Taereung	Hwarangdae
Hwarangdae	Bonghwasan
