57thStreetNQRW	TimesSquare_42ndStreet
TimesSquare_42ndStreet	34thStreetHeraldSquare
34thStreetHeraldSquare	14thStreetUnionSquare
14thStreetUnionSquare	CanalStreet46X
CanalStreet46X	DeKalbAvenueX
DeKalbAvenueX	AtlanticAvenue_PacificStreet
AtlanticAvenue_PacificStreet	SeventhAvenueBROOK
SeventhAvenueBROOK	ProspectPark
ProspectPark	ParksideAvenue
ParksideAvenue	ChurchAvenueBQ
ChurchAvenueBQ	BeverleyRoad
BeverleyRoad	CortelyouRoad
CortelyouRoad	NewkirkAvenueBQ
NewkirkAvenueBQ	AvenueH
AvenueH	AvenueJ
AvenueJ	AvenueM
AvenueM	KingsHighwayBQ
KingsHighwayBQ	AvenueUQ
AvenueUQ	NeckRoad
NeckRoad	SheepsheadBay
SheepsheadBay	BrightonBeach
BrightonBeach	OceanParkway
OceanParkway	WestEighthStreetNewYorkAquarium
WestEighthStreetNewYorkAquarium	ConeyIslandStillwellAvenue
