SongjiangXincheng	SongjiangUniversityTown
SongjiangUniversityTown	Dongjing
Dongjing	Sheshan
Sheshan	Sijing
Sijing	Jiuting
Jiuting	ZhongchunRoad
ZhongchunRoad	Qibao
Qibao	XingzhongRoad
XingzhongRoad	HechuanRoad
HechuanRoad	CaohejingHi-TechPark
CaohejingHi-TechPark	GuilinRoad
GuilinRoad	YishanRoad
YishanRoad	Xujiahui
Xujiahui	ZhaojiabangRoad
ZhaojiabangRoad	JiashanRoad
JiashanRoad	Dapuqiao
Dapuqiao	MadangRoad
MadangRoad	LujiabangRoad
LujiabangRoad	Xiaonanmen
Xiaonanmen	ShangchengRoad
ShangchengRoad	CenturyAvenue
CenturyAvenue	MiddleYanggaoRoad
