BoulognePontdeSaintCloud	BoulogneJeanJaures
BoulogneJeanJaures	MichelAngeMolitor
MichelAngeMolitor	ChardonLagache
ChardonLagache	Mirabeau
Mirabeau	JavelAndreCitroen
JavelAndreCitroen	CharlesMichels
JavelAndreCitroen	Eglised'Auteuil
Eglised'Auteuil	MichelAngeAuteuil
MichelAngeAuteuil	Ported'Auteuil
Ported'Auteuil	BoulogneJeanJaures
CharlesMichels	AvenueEmileZola
AvenueEmileZola	LaMottePicquetGrenelle
LaMottePicquetGrenelle	Segur
Segur	Duroc
Duroc	Vaneau
Vaneau	SevresBabylone
SevresBabylone	Mabillon
Mabillon	Odeon
Odeon	ClunyLaSorbonne
ClunyLaSorbonne	MaubertMutualite
MaubertMutualite	CardinalLemoine
CardinalLemoine	Jussieu
Jussieu	Gared'Austerlitz
